1111111111111
10000000E0001
1001000000001
100100000C001
1001000000001
10011C00C0001
1001111111011
1000000000001
100P011111001
1111111111111
