11111111111111111111111
10000000000000000000001
10P00001001100000000001
10000011010010000000001
10000101C0010000000E001
100011110010C0000000001
10000001011110000000001
10000000000000000000001
11111111111111111111111
