1111111
1C01011
1E01001
1P01101
1111111
